XXXXXXXXXXXXXXXXXXXXXXXXXXXXXXXXXXXX
X X X X X X X X X X X X X X X X X XX
X W                                X
XX X X X X X X X X X X X X X X X X X
X                                  X
X X X XGX X X X X X X X X XGX X X XX
X                                  X
XX X X X X X X X X X X X X X X X X X
X                         R        X
X X X X X X X X X X X X X X X X X XX
X               G                  X
XX X X X X X X X X X X X X X X X X X
X                                  X
X X X X X X X X X X X X X X X X X XX
X       R       S                  X
XX X X X X X X X X X X X X X X X X X
X                       R          X
X X X X X X X X X X X X X X X X X XX
X                                  X
XX X X X X X X X X X X X X X X X X X
X    R                             X
X X X X X X X X X X X X X X X X X XX
X                                  X
XX X X X X X X X X X X X X X X X X X
X           G                      X
X X X X X X X X X X X X X X X X X XX
X                        G         X
XX X X X X X X X X X X X X X X X X X
X      G                           X
X X X X X X X X X X X X X X X X X XX
X                                  X
XX X X X X X X X X X X X X X X XEX X
XXXXXXXXXXXXXXXXXXXXXXXXXXXXXXXXXXXX
