XXXXXXXXXXXXXXXXXXXXXXXXXXXXXXXXXXXX
X W               X                X
X                 X                X
X     X  X   X         XXXXXXG     X
X                           XG     X
X     X X  X              X XG     X
X X X X          XX       X XG     X
X X X X                   X       XX
X X              XXXXXXXX X       XX
X X   X     X    X        X       XX
X X   X    XXX   X                XX
X X   XXX XX     X     R          XX
X     X                          XXX
X     X           X             SXXX
X     X                          XXX
X     X                          XXX
X     X             R            XXX
X                                XXX
X                                 XX
X     X                     X     XX
XXXX        R               X   X XX
X XX  X              X      X   X  X
X     X         X    X  XXX X   X  X
X             X      X  XX  X   X  X
X            X       X      X      X
X          X                X      X
X  XXX XX                          X
X  X           X               X X X
X              X               X X X
X                      X X X  XX X X
X   XX X XX XX X               XXX X
X            X X               E   X
XXXXXXXXXXXXXXXXXXXXXXXXXXXXXXXXXXXX
